111111111
1P0000001
100111001
1C0010C01
100000001
1000E0001
111111111
