1111111111
1P1000C001
10100010C1
101000E001
1010001001
100000C001
1111111111
