111111111111
1P000000C001
100111100001
1C0100000C01
100100111001
100100000001
1001000C00E1
100000000001
111111111111
