11111111111
1P0110000E1
1001100C001
100000C1001
101111010C1
100000000C1
11111111111
