111111111111111
1P0000C00000001
1011111110111C1
10000000C0100E1
101111110010001
10C00000001C001
111010111010001
1000100000100C1
1011101011101C1
100000000000001
111111111111111
