1111
10P1
11111111
10P1
11111111
10P1
11111111
10P1
11111111
10P1
11111111
10P1
11111111
10P1
11111111
10P1
11111111
10P1
11111111
10P1
11111111
10P1
11111111
10P1
11111111
10P1
11111111
10P1
11111111
10P1
11111111
10P1
11111111
10P1
11111111
10P1
11111111
10P1
11111111
10P1
11111111
10P1
11111111
10P1
11111111
10P1
11111111
10P1
11111111
10P1
11111111
10P1
11111111
10P1
11111111
10P1
11111111
10P1
11111111
10P1
11111111
10P1
11111111
10P1
11111111
10P1
11111111
10P1
11111111
10P1
11111111
10P1
11111111
10P1
11111111
10P1
11111111
10P1
11111111
10P1
11111111
10P1
11111111
10P1
11111111
10P1
11111111
10P1
11111111
10P1
11111111
10P1
11111111
10P1
11111111
10P1
11111111
10P1
11111111
10P1
11111111
10P1
11111111
10P1
11111111
10P1
11111111
10P1
11111111
10P1
11111111
10P1
11111111
10P1
11111111
10P1
11111111
10P1
11111111
10P1
11111111
10P1
11111111
10P1
11111111
10P1
11111111
10P1
11111111
10P1
11111111
10P1
11111111
10P1
11111111
10P1
11111111
10P1
11111111
10P1
11111111
10P1
11111111
10P1
11111111
10P1
11111111
10P1
11111111
10P1
11111111
10P1
11111111
10P1
11111111
10P1
11111111
10P1
11111111
10P1
11111111
10P1
11111111
10P1
11111111
10P1
11111111
10P1
11111111
10P1
11111111
10P1
11111111
10P1
11111111
10P1
11111111
10P1
11111111
10P1
11111111
10P1
11111111
10P1
11111111
10P1
11111111
10P1
11111111
10P1
11111111
10P1
11111111
10P1
11111111
10P1
11111111
10P1
11111111
10P1
11111111
10P1
11111111
10P1
11111111
10P1
11111111
10P1
11111111
10P1
11111111
10P1
11111111
10P1
11111111
10P1
11111111
10P1
11111111
10P1
11111111
10P1
1111
